R 900 900

NO ./textures/1-2.xpm
SO ./textures/1-2.xpm
WE ./textures/1-2.xpm
EA ./textures/1-2.xpm

S ./textures/barrel.xpm
F 53,59,72
C 72,126,176

        1111111111111111111111111         1111111
        1000000000110000000000001         1003001
        1011000001110000002005001         1000001
        1001000200D00000000000001         1R000R1
111111111011000001110200002000001         1RRRRR1
10000000001100000111D111111111111         1RRRRR1
11110111111111011100000010PP1             1111111
11110111111111011101010010PA1
110000001101010111000000D5401
11000000110101011100000010001
10040000000000001101010010001
11000001110101011111011110N01111
11113111 1110101 101111010001 
11111111 1111111 1111111111111