R 640 640

NO ./textures/1-2.xpm
SO ./textures/1-2.xpm
WE ./textures/1-2.xpm
EA ./textures/1-2.xpm

S ./textures/barrel.xpm
F 53,59,72
C 72,126,176

        1111111111111111111111111
        1000000000110000000000001
        1011000001110000002000001
        1001000200000000000000001
111111111011000001110200002000001
100000000011000001110111111111111
11110111111111011100000010001
11110111111111011101010010001
11000000110101011100000000001
11000000110101011100000010001
10000000000000001101010010001
11000001110101011111011110N0111
11110111 1110101 101111010001
11111111 1111111 111111111111